1111111111111
10010000P00C1
10C0011101001
1C0011E0C00P1
1111111111111